####################
#G****#######*****G#
#####*&*****&P*#####
#******************#
#**#*#############*#
#****#######*S*##* #
#****&*****&*#*****#
#*#*#######*####**C#
#*#*******#*####*###
#*#*#*#*#*#***##*###
#*#*#*#*#***#*##*#C#
#*&*#*#*#####******#
#####*&*****&**#####
#G****#######*****G#
####################
